35
AR
1
8 5
* * * * *
* O20 . . *
* . * O20 *
PE . O20 . *
* . * * *
* . . . .
* * * * PS
* * * * *